111111121111111
111111111111111
111111111111111
111211111111111
222211111111111
111111112211122
111111112211111
111111112211111
111111111111111
222211111111111
111211111111111
111111111111111
111111111111112
111111111111112
111111222211112
111111111211111
111111111111111
111111111111111
111111111111111
111111222111111
