111111111111111
111111111111111
111111111121111
111111111112111
222211111121111
111111111111111
111111111111111
111111111111112
111111222111112
222111111111112
111111111111111
111111111111111
111111222111112
111121111111112
111211111111112
111121111111111
111112222111111
111111112111111
111111112111111
111111112111111
