211111112111111
121111112111111
111111112111111
111111111111112
111111111111111
111111111111111
111121111112222
111121111112111
111122221112111
111111111111111
111111111111111
111111111111111
111112111111111
222222111222222
111111111111111
111111111111111
111111111111111
111111121111111
111111121111121
111111121111112