111211111112111
111211111111111
111211111111111
111111111121111
111111111121111
111111121121111
222111111111111
111111111111111
111111111111111
111111111111111
112221112111211
121111112111121
211111112111121
111111111111121
111111111111111
111111111111111
111111122211111
111111211111111
111112111111111
111121111111111
