111111111111111
111111111111112
111111111111121
111111111111211
111111111112111
111111111121111
111111111211111
111111111111111
111121111111111
111112111111111
111111211111111
211111121111111
121111112111111
112111111111111
111211111111111
111111111111111
111111111111111
111111111112111
111112111121111
111121111211111