111111111112111
111111111112111
111111111112111
111111111111111
111111111121111
111111111111111
111111111121111
222111111121111
111111122221111
111111111111111
111111111111111
111111111111111
111111111111111
111111222111111
111111111111111
111111111111111
111111111111111
111112111211111
111112111211121
111112111211111