111111111111111
111111111111111
111111121111111
111111111111111
111111111111111
111111111112221
222222111111111
111111111111111
111111111111111
111111111121111
111111111111111
111112221111111
111111111111111
111111111111111
121111111111111
111111111111111
111111111112211
111111121112111
111111111112111
111111111112111